                          NO   ./textures/NO/teapot.xpm


SO textures/SO/teapot.xpm


WE textures/WE/teapot.xpm

F 2,    1,000
C 225,30,000



EA        textures/EA/teapot.xpm

		1111111111111111111111111
		1000000000110000000000001
		1011000001110000000000001
		10010000000000000000000111111111
		1111111110110000011100000000000011
		1111111111111111111111111111111111















				111111
				100W01
				111111





